-	ー
,	、

;	っ
zh	←
zj	↓
zl	→
zk	↑
[	「
]	」
~	〜
la	ぁ
li	ぃ
lu	ぅ
le	ぇ
lo	ぉ
xa	ぁ
xi	ぃ
xu	ぅ
xe	ぇ
xo	ぉ
a	あ
i	い
u	う
e	え
o	お
ka	か
kq	かい
kz	かん
ki	き
k;	きい
kf	きん
ku	く
k.	くう
kv	くん
ke	け
k,	けい
kc	けん
ko	こ
kw	こう
kx	こん
ga	が
gq	がい
gz	がん
gi	ぎ
g;	ぎい
gf	ぎん
gu	ぐ
g.	ぐう
gv	ぐん
ge	げ
g,	げい
gc	げん
go	ご
gw	ごう
gx	ごん
sa	さ
sq	さい
sz	さん
si	し
s;	しい
sf	しん
su	す
s.	すう
sv	すん
se	せ
s,	せい
sc	せん
so	そ
sw	そう
sx	そん
za	ざ
zq	ざい
zz	ざん
zi	じ
z;	じい
zf	じん
zu	ず
z.	ずう
zv	ずん
ze	ぜ
z,	ぜい
zc	ぜん
zo	ぞ
zw	ぞう
zx	ぞん
ta	た
tq	たい
tz	たん
ti	ち
t;	ちい
tf	ちん
tu	つ
t.	つう
tv	つん
te	て
t,	てい
tc	てん
to	と
tw	とう
tx	とん
da	だ
dq	だい
dz	だん
di	ぢ
d;	ぢい
df	ぢん
du	づ
d.	づう
dv	づん
de	で
d,	でい
dc	でん
do	ど
dw	どう
dx	どん
na	な
nq	ない
nz	なん
ni	に
n;	にい
nf	にん
nu	ぬ
n.	ぬう
nv	ぬん
ne	ね
n,	ねい
nc	ねん
no	の
nw	のう
nx	のん
ha	は
hq	はい
hz	はん
hi	ひ
h;	ひい
hf	ひん
hu	ふ
h.	ふう
hv	ふん
he	へ
h,	へい
hc	へん
ho	ほ
hw	ほう
hx	ほん
ba	ば
bq	ばい
bz	ばん
bi	び
b;	びい
bf	びん
bu	ぶ
b.	ぶう
bv	ぶん
be	べ
b,	べい
bc	べん
bo	ぼ
bw	ぼう
bx	ぼん
pa	ぱ
pq	ぱい
pz	ぱん
pi	ぴ
p;	ぴい
pf	ぴん
pu	ぷ
p.	ぷう
pv	ぷん
pe	ぺ
p,	ぺい
pc	ぺん
po	ぽ
pw	ぽう
px	ぽん
ma	ま
mq	まい
mz	まん
mi	み
m;	みい
mf	みん
mu	む
m.	むう
mv	むん
me	め
m,	めい
mc	めん
mo	も
mw	もう
mx	もん
ya	や
yq	やい
yz	やん
yu	ゆ
y.	ゆう
yv	ゆん
yo	よ
yw	よう
yx	よん
ra	ら
rq	らい
rz	らん
ri	り
r;	りい
rf	りん
ru	る
r.	るう
rv	るん
re	れ
r,	れい
rc	れん
ro	ろ
rw	ろう
rx	ろん
wa	わ
wq	わい
wz	わん
wo	を
ww	をう
wx	をん
q	ん
kja	きゃ
kjq	きゃい
kjz	きゃん
kju	きゅ
kj.	きゅう
kjv	きゅん
kjo	きょ
kjw	きょう
kjx	きょん
gja	ぎゃ
gjq	ぎゃい
gjz	ぎゃん
gju	ぎゅ
gj.	ぎゅう
gjv	ぎゅん
gjo	ぎょ
gjw	ぎょう
gjx	ぎょん
sja	しゃ
sjq	しゃい
sjz	しゃん
sju	しゅ
sj.	しゅう
sjv	しゅん
sje	しぇ
sj,	しぇい
sjc	しぇん
sjo	しょ
sjw	しょう
sjx	しょん
ja	じゃ
jq	じゃい
jz	じゃん
ji	じ
j;	じい
jf	じん
ju	じゅ
j.	じゅう
jv	じゅん
je	じぇ
j,	じぇい
jc	じぇん
jo	じょ
jw	じょう
jx	じょん
zja	じゃ
zjq	じゃい
zjz	じゃん
zju	じゅ
zj.	じゅう
zjv	じゅん
zjo	じょ
zjw	じょう
zjx	じょん
tja	ちゃ
tjq	ちゃい
tjz	ちゃん
tju	ちゅ
tj.	ちゅう
tjv	ちゅん
tje	ちぇ
tj,	ちぇい
tjc	ちぇん
tjo	ちょ
tjw	ちょう
tjx	ちょん
cja	ちゃ
cjq	ちゃい
cjz	ちゃん
cju	ちゅ
cj.	ちゅう
cjv	ちゅん
cjo	ちょ
cjw	ちょう
cjx	ちょん
nla	にゃ
nlq	にゃい
nlz	にゃん
nlu	にゅ
nl.	にゅう
nlv	にゅん
nlo	にょ
nlw	にょう
nlx	にょん
hla	ひゃ
hlq	ひゃい
hlz	ひゃん
hlu	ひゅ
hl.	ひゅう
hlv	ひゅん
hlo	ひょ
hlw	ひょう
hlx	ひょん
bja	びゃ
bjq	びゃい
bjz	びゃん
bju	びゅ
bj.	びゅう
bjv	びゅん
bjo	びょ
bjw	びょう
bjx	びょん
pja	ぴゃ
pjq	ぴゃい
pjz	ぴゃん
pju	ぴゅ
pj.	ぴゅう
pjv	ぴゅん
pjo	ぴょ
pjw	ぴょう
pjx	ぴょん
mla	みゃ
mlq	みゃい
mlz	みゃん
mlu	みゅ
ml.	みゅう
mlv	みゅん
mlo	みょ
mlw	みょう
mlx	みょん
rja	りゃ
rjq	りゃい
rjz	りゃん
rju	りゅ
rj.	りゅう
rjv	りゅん
rjo	りょ
rjw	りょう
rjx	りょん
whi	うぃ
wh;	うぃい
whf	うぃん
whe	うぇ
wh,	うぇい
whc	うぇん
whe	うぉ
wh,	うぉう
whc	うぉん
va	ゔぁ
vq	ゔぁい
vz	ゔぁん
vi	ゔぃ
v;	ゔぃい
vf	ゔぃん
vu	ゔ
v.	ゔう
vv	ゔん
ve	ゔぇ
v,	ゔぇい
vc	ゔぇん
vo	ゔぉ
vw	ゔぉう
vx	ゔぉん
thi	てぃ
th;	てぃい
thf	てぃん
dhi	でぃ
dh;	でぃい
dhf	でぃん
fa	ふぁ
fq	ふぁい
fz	ふぁん
fi	ふぃ
f;	ふぃい
ff	ふぃん
fu	ふぅ
f.	ふぅう
fv	ふぅん
fe	ふぇ
f,	ふぇい
fc	ふぇん
fo	ふぉ
fw	ふぉう
fx	ふぉん
